21
21
111111111111111111111
100000100010000010001
111110101010111011101
100000101000101000001
101111101111101111101
101000100010000000001
101010111210111111111
100010000010100000001
111111111110101110111
100000000010100010001
111111101110111111101
100000100010100001011
101110111010101110101
101000000010101000001
101111111110101111101
101000000010100000101
101011111010111110111
101010001010100010001
101011101010101011101
100000001000001000301
111111111111111111111
